11111111111111111111
10000000000000000001
10000000000000000001
10000100000100000001
10000000000000000001
10000100001000000001
10000000000000000001
10000000000000000001
10000000000000000001
10000000000000000001
11111111111100100001
10000001000000100001
10000001000000100001
10011111000000100001
10000001110011100001
10000000000000100001
10000000000000100001
10000000000000100001
11111111111111111111